downtown: trung tâm thành phố
head to somewhere: đi đến đâu đó
portfolio: danh mục
unworn: chưa cũ, chưa mòn
engaging: hấp dẫn
be composed of: bao gồm, tạo nên từ
be aimed at doing sth: nhằm mục đích
staffing agency: cơ quan nhân sự
headquater: trụ sở
corporate: liên quan đến công ty
proprietary: độc quyền
to safeguard: bảo vệ
executive: giám đốc
rigorous: nghiêm khắc, nghiêm ngặt
thoroughly: một cách triệt để
to void sth: vô hiệu hóa
artifact: hiện vật
patron: khách hàng (lq đến nghệ thuật)
exhibit: triển lãm
renowned: nổi tiếng
contemporary: đương đại
curator: người phụ trách
vast: lớn, rộng
expertise: kinh nghiệm, k/thức chuyên môn
clay pottery: đồ gốm đất
mural: tranh tường
delivery slip: phiếu giao hàng
be supposed to do sth: đáng lẽ ra...
engage with: tham gia với
literacy: k/n đọc + viết
to inhibit: ức chế, ngăn chặn
venue: địa điểm, chỗ tụ họp
be not eligible for: k thích hợp
prescribe: quy định
conference chair: chủ tịch hội nghị
pediatric: thuộc nhi khoa
opening: chỗ còn trống
oral health: sức khỏe răng miệng
to cultivate: trau dồi
graduate: sau đại học
boast: nói 1 cách tự hào, tự hào
commute from A to B: đi từ A đến B
superb: tuyệt dời
sauteed: xào
to craft: chế biến
culinary teacher: giáo viên ẩm thực