display case: khung trưng bày
post: cái cột
notice: bảng chú ý
consultant: tư vấn viên
due: quá hạn
email: gửi mail
shuttle service: dịch vụ đưa đón
get a ride back: trở về
service charge: phí dịch vụ
invoice: hóa đơn
to charge: thu phí
ahead of time: trước, sớm
to waive: bỏ qua (trong trường hợp đặc biệt)
let up: bớt, dứt (mưa)
field: sân
commercial: quảng cáo
trade show: triển lãm thương mại
maintenance crew: đội ngũ bảo trì
be out of order: hỏng, không hoạt động
apparently: có vẻ như
as usual: như thường lệ
semiannual: giữa năm/ 2 lần 1 năm
apprenticeship: việc học nghề
welding: hàn (kim loại)
coordinator: điều phối viên
associate: cộng sự
ballroom: phòng khiêu vũ
awards ceremony: lễ trao giải
wall socket: ổ cắm điện
outlet: ổ
blood test: xét nghiệm máu
garment: quần áo
booth: quầy, gian hàng, quán
entrée: món ăn chính
flight attendant: tiếp viên hàng không
kitchen appliance: dụng cụ bếp
to conduct: chỉ đạo, chủ trì
federal: liên bang
track: đường ray
passersby: người qua đường
approve of sth: tán thành
warehouse: nhà kho
itinerary: hành trình