lately: gần đây
auditorium: khán phòng
screenplay: kịch bản
city hall: tòa thị chính
innovative: đổi mới
be acknowledged: được ghi nhận
slight: nhẹ, mong manh
now that: (conj) bởi vì + mệnh đề
as though: (conj) như thể + mệnh đề
officer: cán bộ
loan application: đơn xin vay
courtesy: sự lịch sự
considerably: 1 cách đáng kể
nevertheless: tuy nhiên
proximity + to sb/sth: sự gần với ai đó / cái gì đó
adequate: phù hợp, đầy đủ
be unveiled: được tiết lộ
hedge: hàng rào
nursery: vườn ươm
to offer: cung cấp (cơ hội)
specialist: n.chuyên gia, adj.có kiến thức chuyên sâu
central: n.trung tâm chính, adj.trung tâm
personnel: những công chức, nhân viên, nhân sự
sizeable: đáng kể, lớn
pianist: nghệ sĩ dương cầm
conservatory: nhạc viện
budget cut: cắt giảm ngân sách
state of the art: hiện đại, tối tân
administrative: thuộc về hành chính
lounge: phòng chờ
even though: (conj) mặc dù
to recall: thu hồi
faulty: bị lỗi, có khuyết điểm
to troubleshoot: khắc phục sự cố/lỗi
defect: khiếm khuyết
to interfere: can thiệp
clarity: sự rõ ràng
according to: (prep) theo như
avenue: đại lộ
be located: (+ in/at) được đặt
branch location: địa điểm chi nhánh
thoroughly: 1 cách kĩ lưỡng
payroll: bảng phát lương
quarter: quý
mentor: người cố vấn